  ------------------  
                      
                      
|                    |
|                    |
|                    |
|                    |
|                    |
|                    |
|                    |
|         ##         |
|         ##         |
|                    |
|                    |
|                    |
|                    |
|                    |
|                    |
|                    |
                      
                      
  ------------------  
