----------------------
|#                  #|
|                    |
|                    |
|                    |
|    #          #    |
|                    |
|                    |
|                    |
|                    |
|         ##         |
|         ##         |
|                    |
|                    |
|                    |
|                    |
|    #          #    |
|                    |
|                    |
|                    |
|#                  #|
----------------------
