######################
|                    #
|                    |
|                    |
|                    |
|                    |
|            343     |
|                    |
|                    |
|                    |
|                    |
|                    |
|                    |
|                    |
|                    |
|                    |
|                    |
|                    |
|                    |
|                    |
|                    |
######################